1111111111111
1000000000001
1000000P00001
1111110011111
111100C000001
10000CEC00001
1111111111111