11111111111111111111111111111111111111111111111111111111111
10000CC11CC000111111111111111CC0000000001111111111111111111
100000000000000000000000C00001111111000000000000000000010C1
10000000CC0111111001111100000111100000I00000000011111111001
10C0000011000000C111100000000000000000000000000111111110001
100000000C011111E000000C0I000111111110000000000000000000001
10C00I000C0111111000001100000001110001100000000000I00000001
10000000000CC1001110111001100000000011110000000011111100001
1000000C00011110001C00C0001C010000000I11000000001CC001CCI01
100000000P000000111001110C0001000000CCC00000000010000000001
10000000000C1000100011110C00010000000000000000001C000000001
10000C00000C10001C0000000C000000000001100000000010000000001
10000I00000111001111111100000I00000001111100000010000000001
1C1111111001000100111111000001000000001011100000C0000C00001
100C10000001000000000000000001111100001000000000I0000000001
100010000001CC0010000000000001C0001000111111000000000000001
10000000000011001C000000000001000000000000000000CC000C00001
11111111111111111111111111111111111111111111111111111111111